10
21

     012345678901234567890
   0 ##########E##########
   1 # ######## #        #
   2 # ##       ######## #
   3 # ########          #
   4 #          ##########
   5 # ###################
   6 #           #########
   7 # #########         #
   8 # #         ####### #
   9 ###################S#